1311111111111111111111111
1222211212222122212211111
1211211212122121111211111
1222111222111122222221111
1212222212122212111122111
1221212212121212211122211
1212211122121211211111221
1112112222221222212222121
1112222111121211112111221
1122111222121211122211211
1121112211112212221112221
1122222111111222111111121
1111111111111111222222221
1111111111111111211121121
1111111111111111111111141