1311111111111111111111111
1212222222221222222222211
1212111111121211111111211
1212222222121212211111211
1211111112121211222222211
1212222222121221211111211
1212111111121121222222211
1212122222222221111111211
1212121111111111222122211
1212121222222222212221111
1212121211111111111111111
1222121222222222222222211
1211121211111111211111111
1222221112222222222222211
1111111111111111111141111