1311111111111111111111111
1222222222222222222222221
1111111111111211111111111
1222222222222222222222221
1111111111111111121111111
1222222222222222222222221
1111111121111111111111111
1222222222222222222222221
1111121111111111111111111
1111221222122212221222121
1222211212221222122212221
1211122211111111111111121
1221221112222222222212221
1122211222222222221222121
1111111111111111411111111